Средний палец - МГЕ братья
Ассоциация Лю - Любители KFC
Безымянный палец - Эрекционное кольцо
Родословная Клинка Сальсу - Родословная MTL
Ассоциация Дьечи - Ассоциация Католиков
Пекода - ВДВ
Ассоциация Севен - Ассоциация Семя
Мультикрэк - Мультикокс
Грозовой Перевал - Перевал Дятлова
Ассоциация Цвай - ЧОПики
Ассоциация Сэнк - Ассоциация Обкурышей
Ла Манчаленд - Мочаленд
Ассоциация Си - Ассоциация Сиси
Стая Хейшоу Мао - Стая Боевых Хомяков
Род Эдгар - Дом престарелых
Шеф-повар БуР - Огузок/Шеф из "Кухня"
Клан Курокумо - Клан Кресчент
Юродивые - Коммунисты
Офис «Остановки развития» - Офис Остановки Тромба
Бом-боб - Бимбамбомбимбам\nБебебебебе
Дикая Охота - Охота Крепкое
Ассоциация Девять - Ассоциация Яндекс Курьеров
Офис Рассвета - Офис Даунов
Марьячи - Бубновый черт
Офис Пламенных кулаков - Офис Ебучих Крикунов
Пират двух крюков - Александр Пистолетов
К. Корп - Корпорация фанатов спермы деда
W Corp. - МГЕ Паровозик W
T Corp. - Т-Банк
ТЕСТ MAIN MAIN 123- ---ТЕСТ MAIN MAIN 123- ---ТЕСТ MAIN MAIN 123- ---ТЕСТ MAIN MAIN 123- ---ТЕСТ MAIN MAIN 123- ---
